0000000000
1111100011
0000000000
1110000000
0000001111
0000000000
2222000000
0000000222
0000000000
0000000000
