000000020000000
222200000002222
000000000000000
111111111111111
010000000000010
010002121200010
010001111100010
010002121200010
010001111100010
010002121200010
010000000000010
111111111111111
000000000000000
222200000002222
000000020000000
